%%%%%%%%%%%%%%%%%%%%%%%%%%%%%%%%%%%%%
%                                   %
%            %                      %
%            %                      %
%            %                      %
%            %                      %
%            %                      %
%            %      %               %
%            %      %               %
%            %      %               %
%            %      %               %
%            %      %               %
%            %      %               %
%            %      %              -%
%%%%%%%%%%%%%%      %%%%%%%%%%%%%%%%%
%            %                      %
%            %                      %
%            %                      %
%                                   %
%                                   %
%                                   %
%+                                  %
%%%%%%%%%%%%%%%%%%%%%%%%%%%%%%%%%%%%%
