%%%%%%
%    %
% % -%
%   +%
%%%%%%
