%%%%%%%%%%%%%%%%%%%%%%
% %%        %-%      %
%    %%%%%% % %%%%%% %
%%%%%%        %      %
%    % %%%%%% %% %%%%%
% %%%% %         %   %
%        %%% %%%   % %
%%%%%%%%%%    %%%%%% %
%+         %%        %
%%%%%%%%%%%%%%%%%%%%%%
