%%%%%%%
%    -%
% %%% %
%  %  %
%%   %%
%+ %%%%
%%%%%%%
